14.ox
ooooooooooooooo
..............o
............o.o
.o.o..........o
.o...o........o
......o.o..o..o
.o.o...o......o
..............o
.o............o
........o.....o
.......o......o
.........o....o
.............oo
ooooooooooooooo
